%%%%%%%%%%%%%%%%%%%%%%
%........%...........%
%.       %          .%
%%%%%.      P       .%
%....               .%
%....................%
%%%%%%%%%%%%%%%%%%%%%%