%%%%%%%
%.....%
%.   .%
%.   .%
%.   .%
%.   .%
%.   .%
%.   .%
%.   .%
%%% %%%
%%% %%%
%%% %%%
%%% %%%
%%% %%%
%%% %%%
%%% %%%
%%% %%%
%.. ..%
%.   .%
%. P .%
%.   .%
%.....%
%%%%%%%
