%%%%%%%%
%......%
%.    .%
%.    .%
%.    .%
%.    .%
%.    .%
%.    .%
%.    .%
%%%..%%%
%%%..%%%
%%%..%%%
%%%..%%%
%%%..%%%
%%%..%%%
%%%..%%%
%%%. %%%
%..  ..%
%.    .%
%. P  .%
%.    .%
%......%
%%%%%%%%
